WWWWWWW
WS   SW
W BPB W
W WWW W
W B B W
WS   SW
WWWWWWW