        WWWWWWWW
        W     PW
        W BWB WW
        W B  BW
        WWB B W
WWWWWWWWW B W WWW
WSSSS  WW B  B  W
WWSSS    B  B   W
WSSSS  WWWWWWWWWW
WWWWWWWW