WWWWWWWW
W      W
W P BS W
W      W
WWWWWWWW
