WWWWWWWWW
WS     SW
W W   W W
W SBBBS W
W  BPB  W
W SBBBS W
W W   W W
WS     SW
WWWWWWWWW