 WWWWW
WW   WW
W S S W
W  Q  W
WBWWWWW
WBW
WWW