  WWWWW
WWW   W
WSPB  W
WWW BSW
WSWWB W
W W S WW
WB  BBSW
W   S  W
WWWWWWWW