WWWWW
WP  W
W WBWWW
W B SSW
WWWWWWW