 WWWWW
WW   WW
W S S W
W  P  W
WQWWWWW
WQW
WWW
