      WWWWW
      W   W
   WWWW B WWWW
   W B  B  B W
WWWW         WWWW
W      SSS      W
W B   SSPSS   B W
W      SSS      W
WWWW         WWWW
   W B  B  B W
   WWWW B WWWW
      W   W
      WWWWW