  WWWWW
WWW   W
WSPB  W
WWW BSW
WSWWB W
W W S WW
WB XBBSW
W   S  W
WWWWWWWW