WWWWWWWWWWWW
WSS  W     WWW
WSS  W B  B  W
WSS  WBWWWW  W
WSS    P WW  W
WSS  W W  B WW
WWWWWW WWB B W
  W B  B B B W
  W    W     W
  WWWWWWWWWWWW