WWWWWWWWWWWW
WSIIII  B  W
WSIIII B B W
WIIWWW     W
WIIWWW     W
WISWWW  P  W
WWWWWWWWWWWW